You are in your sunny living room located in West Hollywood, California. You and your best friend Luke are watching a sitcom when suddenly you feel the ground shake immensely. A couple of minutes later, the emergency broadcast informs you that there are numerous amounts of natural disasters occurring in North America. You and Luke look at each other, worried, and you decided to talk to him to see what's on his mind.

Last Hope
An Interactive Fiction by Tatiana Fudo
Release 1 / Serial number 140917 / Inform 7 build 6L02 (I6/v6.33 lib 6/12N) SD

Living room
You are in the sunny living room.

You can see Luke here.

>talk to LUKE
You ask Luke what he thinks you two should do, and he says that you two should grab the car keys located in the Bedroom north of the Living Room, and from the Bedroom go down to the car and from there you two should decide what the best thing to do would be.

>lUKE
That's not a verb I recognise.

>kiss LUke
He not feeling it.

>talk to Steve
You can't see any such thing.

>n
Bedroom
Cabinet and bed located in the bedroom. You remember the keys are in the cabinet.

Luke follows right behind you.

>go down
Street
You head downstairs and out the door and see the terribly damaged street. You take your keys out of your pocket, unlock and get in the car with Luke. You both decide the best thing to do would be to head to the gas station. You see only two paths one being North and the other being East.

Luke follows right behind you.

>e
Gas Station
You arrive at the gas station with barely any gas left. While Luke gets gas for the car you see two people. One looks confused and the other looks worried. You decide to see what's up with them. You first decide to talk to the short girl, Martha.

You can see Martha and Steve here.

Luke follows right behind you.

>talk to Steve
You ask Luke what he thinks you two should do, and he says that you two should grab the car keys located in the Bedroom north of the Living Room, and from the Bedroom go down to the car and from there you two should decide what the best thing to do would be.

* * *

>x living room
You can't see any such thing.

>x Phone
This is a working iPhone 5s that you may or may not use later.

* * *

>talk to hot luke
You can't see any such thing.

>talk to luke
You ask Luke what he thinks you two should do.  He says that you two should grab the car keys located in the Bedroom north of the Living Room, and from the Bedroom go down to the car. From there you two should decide what the best thing to do would be.

>n
Bedroom
Cabinet and bed are located in the bedroom. You remember the keys are in the cabinet.

Luke follows right behind you.

>opn cabinet
That's not a verb I recognise.

>open cabinet
It isn't something you can open.

>unlock cabinet
What do you want to unlock Wooden Cabinet with?

>unlock cabinet with key
(first taking Key)
That doesn't seem to be something you can unlock.

>look
Bedroom
Cabinet and bed are located in the bedroom. You remember the keys are in the cabinet.

You can see Luke here.

>take key
You already have that.

>i
You are carrying:
  Key
  100 Dollars
  Phone

>unlock cabinet
What do you want to unlock Wooden Cabinet with?

>unlock cabinet with key
That doesn't seem to be something you can unlock.

>open cabinet
It isn't something you can open.

>examine cabinet
Wooden Cabinet is empty.

>go down
Street
You head downstairs and out the door and you see the terribly damaged street. You take your keys out of your pocket, unlock the car and get in with Luke. You both decide the best thing to do would be to head to the gas station. You see only two paths, one being North and the other being East.

Luke follows right behind you.

>unlock car
You can't see any such thing.

>n
Hell
Luke follows right behind you.

    *** You and Luke have fallen into the Earth and died.

THE END  ***

Would you like to RESTART, RESTORE a saved game, QUIT or UNDO the last command?

>undo
Street
[Previous turn undone.]

>e
Gas Station
You arrive at the gas station with barely any gas left. While Luke gets gas for the car you see two people. One looks confused and the other looks worried. You decide to see what's up with them. You first decide to talk to the short girl, Martha.

You can see Martha and Steve here.

Luke follows right behind you.

>talk to martha
You approach Martha and while you are attempting to get her attention she suddenly has a heart attack and dies. You freak out a little so you decide to head to the other person there who is named Steve.

>talk to steve
You start talking to Steve and you tell him to slow down because he is continuously rambling on about a secret government map. He then explains that he was a government worker who got his hands on a confidential map that shows a secret shuttle that was built to save some of the more important people. He asks for your help because his car just broke down. He says that he can explain more if they get the map from his house. Luke finishes up filling the tank and you are on your way. However you don't know exactly which way but you now you can't go the way you came from which was west.

>s
Hell
Luke follows right behind you.

    *** You and Luke have fallen into the Earth and died.

THE END  ***

Would you like to RESTART, RESTORE a saved game, QUIT or UNDO the last command?

>undo
Gas Station
[Previous turn undone.]

>e
Steve's House
You finally find the map and it is revealed to you that there is a secret shuttle in Russia that is saving only important people. You, Luke, and Steve take a good look at the map examining where you should go and conclude the first thing to do would be to go to the highway south of Steve's House and head to the Airport.

Luke follows right behind you.

>s
Highway
You forgot which way the airport was but you now you must continue on. You can either go South, East, or West.

Luke follows right behind you.

>s
Airport
You get to the airport and also see large crowds of confused people. It seems that no one is being allowed on the plane and the people are rioting. You see a lonely pilot hiding from the rioters in the corner of the room. You decide it would be best to talk to him.

You can see Pilot here.

Luke follows right behind you.

>talk to pilot
You ask the pilot if he is willing to help and you explain the plan. The pilot looks almost convinced so you look to see if there is anything on you that will make it a definite yes.

>give money to pilot
Pilot takes the 100 Dollars gladly and says to go ahead south to get to the plane so you could get out of there.

>s
Plane
Now that you have a rest time you decide to call your parents to let them know about the shuttle with the phone you had you. They were luckily already in Russia due to the vacation they were currently on. That makes things better. Your plane is going to east in order to get to Russia.

Luke follows right behind you.

>e
Russia's Airport
When getting to the airport, a tragic flood occurs and it looks to be killing everyone. You look around to see what you can do about it and in the corner of the room you see an inflatable raft which you think is a good idea to grab.

You take the raft, already inflated and hightail it out of there. There are three possible exits but you don't have a clue which to pick. You can either go East, South, or North. Choose Wisely.

Luke follows right behind you.

>n
Bridge
Unfortunately, Steve dies because he fell off the raft. Now it's only you and Luke. You also had a close call but Luke saved you. You think to yourself how good he is to you. Anyway, now you need to find out where the secret location is because it's not clear. You see a radio and go over to it to see it if you could possibly tune into a military station.

Luke follows right behind you.

>go over
You can't see any such thing.

>look at radio
It comes in foggy but is soon apparent. The Secret Location to the shuttle is North of the Bridge.

>n
Secret Location
You finally arrive and run into some guards. However, Luke convinces them to let you two past. You're really lucky to have him there. They tell you to go up to the glass doors and from there go west.

Luke follows right behind you.

>go up
Glass Doors
HURRY

Luke follows right behind you.

>w
Shuttle
You finally make it! You are in the midst of some several thousand people but all you can think about is your family. You call for them and from across the room they come running to you. You have been extremely lucky. They leave to get food, leaving you and Luke alone. You don't know if he feels the same but you start wondering if you should be more than friends. In the spur of the moment, you decide you should kiss Luke.

Luke follows right behind you.

* * *

>c me
That's not a verb I recognise.

>xme
That's not a verb I recognise.

>x me
You are a good looking super hot super cool female.

>talk to Luke
You ask Luke what he thinks you two should do, and he says that you two should grab the car keys located in the Bedroom north of the Living Room, and from the Bedroom go down to the car and from there you two should decide what the best thing to do would be.

>x Luke
He is a good looking super hot super cool male. You have always felt a little attaracted.

* * *

>ask Luke
What do you want to ask Luke for?

>talk to Luke
You ask Luke what he thinks you two should do, and he says that you two should grab the car keys located in the Bedroom north of the Living Room, and from the Bedroom go down to the car and drive to the East to the gas station. He says from there on you two should decide what the best thing to do would be.

>n
Bedroom
Cabinet and bed located in the bedroom. You remeber the keys are in the cabinet.

Luke follows right behind you.

>n
You can't go that way.

>look in cabinet
In Wooden Cabinet is Key.

>take key
Taken.

>go down
Street
You take your keys out of your pocket and decide to get in the car and head east with Luke.

Luke follows right behind you.

>e
Gas Station
Luke follows right behind you.

>e
Steve's House
You finally find the map and it is revealed to you that there is a secret shuttle in Russia that is saving only important people. You, Luke, and Steve take a good look at the map examining where you should go and conclude the first thing to do would be to go to the highway south of Steve's House and head to the Airport.

Luke follows right behind you.

>e
You can't go that way.

>e
You can't go that way.

>adkl;fak
That's not a verb I recognise.

>fk
That's not a verb I recognise.

>al;fakl
That's not a verb I recognise.

* * *

>i
You are carrying:
  100 Dollars
  Phone

>i
You are carrying:
  100 Dollars
  Phone

>talk to Luke
You ask Luke what he thinks you two should do, and he says that you two should grab the car keys located in the Bedroom north of the Living Room, and from the Bedroom go down to the car and drive to the East to the gas station. He says from there on you two should decide what the best thing to do would be.

>n
Bedroom
Table and bed located in the bedroom. You remeber the keys are on the table.

* * *

>talk to luk
You can't see any such thing.

>talk to luke
You ask Luke what he thinks you two should do, and he says that you two should grab the car keys located in the Bedroom north of the Living Room, and from the Bedroom go down to the car and from there you two should decide what the best thing to do would be.

>n
Bedroom
Cabinet and bed located in the bedroom. You remember the keys are in the cabinet.

Luke follows right behind you.

>open cabinet
It isn't something you can open.

>look in cabinet
In Wooden Cabinet is Key.

* * *

>take key
Taken.

>go down
Street
You head downstairs and out the door and see the terribly damaged street. You take your keys out of your pocket, unlock and get in the car with Luke. You both decide the best thing to do would be to head to the gas station. You see only two paths one being North and the other being East.

Luke follows right behind you.

>kiss luke
He not feeling it.

>e
Gas Station
You arrive at the gas station with barely any gas left. While Luke gets gas for the car you see two people. One looks confused and the other looks worried. You decide to see what's up with them. You first decide to talk to the short girl, Martha.

You can see Martha and Steve here.

Luke follows right behind you.

>undo
Street
[Previous turn undone.]

>n
Hell
Luke follows right behind you.

    *** You and Luke have fallen into the Earth and died.

THE END  ***

Would you like to RESTART, RESTORE a saved game, QUIT or UNDO the last command?

* * *

>talk to martha
You approach Martha and while you are attempting to get her attention she suddenly has a heart attack and dies. You freak out a little so you decide to head to the other person there who is named Steve.

>talk to steve
You start talking to Steve and first tells him to slow down being he continuously rambles on about a secret government map. He then explains that he was a government worker who got his hands on a confidential map that shows a secret shuttle that was built to save some of the more important people. He asks for your help because his car just broke down. He says that he can explain more if they get the map from his house. Luke finishes up filling the tank and you are on your way. However you don't know exactly which way but you now you can't go the way you came from which was west.

>n
Hell
Luke follows right behind you.

    *** You and Luke have fallen into the Earth and died.

THE END  ***

Would you like to RESTART, RESTORE a saved game, QUIT or UNDO the last command?

>undo
Gas Station
[Previous turn undone.]

>s
Hell
Luke follows right behind you.

    *** You and Luke have fallen into the Earth and died.

THE END  ***

Would you like to RESTART, RESTORE a saved game, QUIT or UNDO the last command?

* * *

>s
Highway
You forgot which way the airport was but you now you must continue on. You can either go South, East, or West.

Luke follows right behind you.

>e
Hell
Luke follows right behind you.

    *** You and Luke have fallen into the Earth and died.

THE END  ***

Would you like to RESTART, RESTORE a saved game, QUIT or UNDO the last command?

>undo
Highway
[Previous turn undone.]

>w
Hell
Luke follows right behind you.

    *** You and Luke have fallen into the Earth and died.

THE END  ***

Would you like to RESTART, RESTORE a saved game, QUIT or UNDO the last command?

>undo
Highway
[Previous turn undone.]

>s
Airport
You get to the airport and also see large crowds of confused people. It seems that no one is being allowed on the plane and the people are rioting. You see a lonely pilot hiding from the rioters in the corner of the room. You decide it would be best to talk to him.

You can see Pilot here.

Luke follows right behind you.

>talk to pilot
You ask the pilot if he is willing to help and you explain the plan. The pilot look almost convinced so you look to see if there is anything on you that will make it a definite yes.

>i
You are carrying:
  Key
  100 Dollars
  Phone

>give money
Whom do you want to give 100 Dollars to?

>give money to pilot
Pilot takes the 100 Dollars gladly and says to go ahead south to get to the plane so you could get out of there.

>s
Plane
Now that you have a rest time you decide to call your parents to let them know about the shuttle with the phone you had you. They were luckily already in Russia due to the vacation they were currently on. That makes things better.

Luke follows right behind you.

>e
Russia's Airport
When getting to the airport, a tragic flood occurs and it looks to be killing everyone. You look around to see what you can do about it and in the corner of the room you see an inflatable raft which you think is a good idea to grab.

You take the raft, already inflated and hightail it out of there. There are three possible exits but you don't have a clue which to pick. You can either go East, South, or North. Choose Wisely.

Luke follows right behind you.

>n
Bridge
Unfortunately Steve dies because he fell of the raft. Now it's only you and Luke. You also had a close call but Luke saved you. You think to yourself how good he is to you. Anyway, now you need to find out where the secret location is because it's not clear. You see a radio and go over to it to see it if you could possibly tune into a military station.

Luke follows right behind you.

>go to radio
You can't see any such thing.

>look at radio
It comes in foggy but is soon apparent. The Secret Location to shuttle is North of the Bridge.

>n
Secret Location
You finally arrive and run into some guards. However, Luke convinces them to let you two past. You're really lucky to have him there. They tell you to go up to the glass doors and from there go west.

Luke follows right behind you.

>w
You can't go that way.

>up
Glass Doors
HURRY

Luke follows right behind you.

>w
Shuttle
You finally make it! You are in the midst of some several thousand people nut all you can think about is your family. You call for them and from across the room they come running for you. You have been extremely lucky. They leave to get food leaving you and Luke alone. You don't know if he feels the same but you start wondering if you should be more then friends. In the spur of the moment you decide you should kiss Luke.

Luke follows right behind you.

>KISS HIM
You can't see 'him' (nothing) at the moment.

>kiss luke
    *** You kiss Luke and after a moment's pause he returns the kiss. You and Luke decide that you should be more than friends and go off happily. You are now saved and you have new found relationship. You have won at life.

BE SAFE ***

Would you like to RESTART, RESTORE a saved game, QUIT or UNDO the last command?

* * *

>n
Bedroom
Cabinet and bed are located in the bedroom. You remember the keys are in the cabinet.

Luke follows right behind you.

>n
You can't go that way.

>x me
You are a good looking super hot super cool female.

>x living room
You can't see any such thing.

>x me
You are a good looking super hot super cool female.

>x Phone
This is a working iPhone 5s that you may or may not use later.

>x car
You can't see any such thing.

>x key
You can't see any such thing.

>i
You are carrying:
  100 Dollars
  Phone

* * *

>n
Bedroom
Cabinet and bed are located in the bedroom. You remember the keys are in the cabinet.

Luke follows right behind you.

>x cabinet
Woah this cabinet is super cool super fresh I like it.

* * *

>n
Bedroom
Cabinet and bed are located in the bedroom. You remember the keys are in the cabinet.

Luke follows right behind you.

>look in cabinet
You can't see inside, since Wooden Cabinet is closed.

>open cabinet
You open Wooden Cabinet, revealing Key.

>take key
Taken.

* * *

>kiss Luke
He's not feeling it.

* * *

>talk to luke
You ask Luke what he thinks you two should do.  He says that you two should grab the car keys located in the Bedroom north of the Living Room, and from the Bedroom go down to the car. From there you two should decide what the best thing to do would be.

>m
That's not a verb I recognise.

>m
That's not a verb I recognise.

>n
Bedroom
Cabinet and bed are located in the bedroom. You remember the keys are in the cabinet.

Luke follows right behind you.

>look in cainet
You can't see any such thing.

>open cabinet
It isn't something you can open.

* * *

>take key
Taken.

>go down
Street
You head downstairs and out the door and you see the terribly damaged street. You take your keys out of your pocket, unlock the car and get in with Luke. You both decide the best thing to do would be to head to the gas station. You see only two paths, one being North and the other being East.

Luke follows right behind you.

>kiss Luke
He not feeling it.

>e
Gas Station
You arrive at the gas station with barely any gas left. While Luke gets gas for the car you see two people. One looks confused and the other looks worried. You decide to see what's up with them. You first decide to talk to the short girl, Martha.

You can see Martha and Steve here.

Luke follows right behind you.

>talk to Martha
You approach Martha and while you are attempting to get her attention she suddenly has a heart attack and dies. You freak out a little so you decide to head to the other person there who is named Steve.

>talk to Steve
You start talking to Steve and you tell him to slow down because he is continuously rambling on about a secret government map. He then explains that he was a government worker who got his hands on a confidential map that shows a secret shuttle that was built to save some of the more important people. He asks for your help because his car just broke down. He says that he can explain more if they get the map from his house. Luke finishes up filling the tank and you are on your way. However you don't know exactly which way but you now you can't go the way you came from which was west.

>x me
You are a good looking super hot super cool female.

>x Steve
A ex government official who has got some important news.

>i
You are carrying:
  Key
  100 Dollars
  Phone

>e
Steve's House
You finally find the map and it is revealed to you that there is a secret shuttle in Russia that is saving only important people. You, Luke, and Steve take a good look at the map examining where you should go and conclude the first thing to do would be to go to the highway south of Steve's House and head to the Airport.

Luke follows right behind you.

* * *

>s
Airport
You get to the airport and also see large crowds of confused people. It seems that no one is being allowed on the plane and the people are rioting. You see a lonely pilot hiding from the rioters in the corner of the room. You decide it would be best to talk to him.

You can see Pilot here.

Luke follows right behind you.

>give 100 dollars to pilot
Pilot takes the 100 Dollars gladly and says to go ahead south to get to the plane so you could get out of there.

>s
Plane
Now that you have a rest time you decide to call your parents to let them know about the shuttle with the phone you had you. They were luckily already in Russia due to the vacation they were currently on. That makes things better. Your plane is going to east in order to get to Russia.

Luke follows right behind you.

* * *

>e
Russia's Airport
When getting to the airport, a tragic flood occurs and it looks to be killing everyone. You look around to see what you can do about it and in the corner of the room you see an inflatable raft which you think is a good idea to grab.

You take the raft, already inflated and hightail it out of there. There are three possible exits but you don't have a clue which to pick. You can either go East, South, or North. Choose Wisely.

Luke follows right behind you.

>e
Hell
Luke follows right behind you.

    *** You and Luke have fallen into the Earth and died.

THE END  ***

Would you like to RESTART, RESTORE a saved game, QUIT or UNDO the last command?

>undo
Russia's Airport
[Previous turn undone.]

>s
Hell
Luke follows right behind you.

    *** You and Luke have fallen into the Earth and died.

THE END  ***

Would you like to RESTART, RESTORE a saved game, QUIT or UNDO the last command?

>undo
Russia's Airport
[Previous turn undone.]

>w
Plane
Now that you have a rest time you decide to call your parents to let them know about the shuttle with the phone you had you. They were luckily already in Russia due to the vacation they were currently on. That makes things better. Your plane is going to east in order to get to Russia.

Luke follows right behind you.

>e
Russia's Airport
When getting to the airport, a tragic flood occurs and it looks to be killing everyone. You look around to see what you can do about it and in the corner of the room you see an inflatable raft which you think is a good idea to grab.

You take the raft, already inflated and hightail it out of there. There are three possible exits but you don't have a clue which to pick. You can either go East, South, or North. Choose Wisely.

Luke follows right behind you.

* * *

>n
Bridge
Unfortunately, Steve dies because he fell off the raft. Now it's only you and Luke. You also had a close call but Luke saved you. You think to yourself how good he is to you. Anyway, now you need to find out where the secret location is because it's not clear. You see a radio and go over to it to see it if you could possibly tune into a military station.

Luke follows right behind you.

>look at radio
It comes in foggy but is soon apparent. The Secret Location to the shuttle is North of the Bridge.

* * *

>w
Shuttle
You finally make it! You are in the midst of some several thousand people but all you can think about is your family. You call for them and from across the room they come running to you. You have been extremely lucky. They leave to get food, leaving you and Luke alone. You don't know if he feels the same but you start wondering if you should be more than friends. In the spur of the moment, you decide you should kiss Luke.

Luke follows right behind you.

>kiss Luke
    *** You kiss Luke and after a moment's pause he returns the kiss. You and Luke decide that you should be more than friends and go off happily. You are now saved and you have a new found relationship. You have won at life.

BE SAFE ***

Would you like to RESTART, RESTORE a saved game, QUIT or UNDO the last command?

>restart
You are in your sunny living room located in West Hollywood, California. You and your best friend Luke are watching a sitcom when suddenly you feel the ground shake immensely. A couple of minutes later, the emergency broadcast informs you that there are numerous amounts of natural disasters occurring in North America. You and Luke look at each other, worried, and you decided to talk to him to see what's on his mind.

Last Hope
An Interactive Fiction by Tatiana Fudo
Release 1 / Serial number 140910 / Inform 7 build 6L02 (I6/v6.33 lib 6/12N) SD

Living room
You are in the sunny living room.

You can see Luke here.

>take all
There are none at all available!

>talk to Luke
You ask Luke what he thinks you two should do.  He says that you two should grab the car keys located in the Bedroom north of the Living Room, and from the Bedroom go down to the car. From there you two should decide what the best thing to do would be.

>n
Bedroom
Cabinet and bed are located in the bedroom. You remember the keys are in the cabinet.

Luke follows right behind you.

>take all
Key: Taken.

>go down
Street
You head downstairs and out the door and you see the terribly damaged street. You take your keys out of your pocket, unlock the car and get in with Luke. You both decide the best thing to do would be to head to the gas station. You see only two paths, one being North and the other being East.

Luke follows right behind you.

>take all
There are none at all available!

>e
Gas Station
You arrive at the gas station with barely any gas left. While Luke gets gas for the car you see two people. One looks confused and the other looks worried. You decide to see what's up with them. You first decide to talk to the short girl, Martha.

You can see Martha and Steve here.

Luke follows right behind you.

>take all
There are none at all available!

>e
Steve's House
You finally find the map and it is revealed to you that there is a secret shuttle in Russia that is saving only important people. You, Luke, and Steve take a good look at the map examining where you should go and conclude the first thing to do would be to go to the highway south of Steve's House and head to the Airport.

Luke follows right behind you.

>take all
Street Map: Taken.

>s
Highway
You forgot which way the airport was but you now you must continue on. You can either go South, East, or West.

Luke follows right behind you.

* * *

>s
Airport
You get to the airport and also see large crowds of confused people. It seems that no one is being allowed on the plane and the people are rioting. You see a lonely pilot hiding from the rioters in the corner of the room. You decide it would be best to talk to him.

You can see Pilot here.

Luke follows right behind you.

>give 100 dollars
Whom do you want to give 100 Dollars to?

>give money to pilot
Pilot takes the 100 Dollars gladly and says to go ahead south to get to the plane so you could get out of there.

* * *

>e
Russia's Airport
When getting to the airport, a tragic flood occurs and it looks to be killing everyone. You look around to see what you can do about it and in the corner of the room you see an inflatable raft which you think is a good idea to grab.

You take the raft, already inflated and hightail it out of there. There are three possible exits but you don't have a clue which to pick. You can either go East, South, or North. Choose Wisely.

Luke follows right behind you.

>take all
Raft: Taken.

>n
Bridge
Unfortunately, Steve dies because he fell off the raft. Now it's only you and Luke. You also had a close call but Luke saved you. You think to yourself how good he is to you. Anyway, now you need to find out where the secret location is because it's not clear. You see a radio and go over to it to see it if you could possibly tune into a military station.

Luke follows right behind you.

>take all
There are none at all available!

>look at radio
It comes in foggy but is soon apparent. The Secret Location to the shuttle is North of the Bridge.

* * *

>kiss Luke
    *** You kiss Luke and after a moment's pause he returns the kiss. You and Luke decide that you should be more than friends and go off happily. You are now saved and you have a new found relationship. You have won at life.

BE SAFE ***

Would you like to RESTART, RESTORE a saved game, QUIT or UNDO the last command?

>kiss Lukerestart
Please give one of the answers above.

Would you like to RESTART, RESTORE a saved game, QUIT or UNDO the last command?

>yes
Please give one of the answers above.

Would you like to RESTART, RESTORE a saved game, QUIT or UNDO the last command?

>restart
You are in your sunny living room located in West Hollywood, California. You and your best friend Luke are watching a sitcom when suddenly you feel the ground shake immensely. A couple of minutes later, the emergency broadcast informs you that there are numerous amounts of natural disasters occurring in North America. You and Luke look at each other, worried, and you decided to talk to him to see what's on his mind.

Last Hope
An Interactive Fiction by Tatiana Fudo
Release 1 / Serial number 140910 / Inform 7 build 6L02 (I6/v6.33 lib 6/12N) SD

Living room
You are in the sunny living room.

You can see Luke here.

* * *

>n
Bedroom
Cabinet and bed are located in the bedroom. You remember the keys are in the cabinet.

Luke follows right behind you.

>open cabinet
You open Wooden Cabinet, revealing Key.

* * *

>take key
Taken.

>x bed
There is nothing on the bed.

>x key
You see nothing special about Key.

>s
Living room
You are in the sunny living room.

Luke follows right behind you.

>s
You can't go that way.

>w
You can't go that way.

>e
You can't go that way.

>n
Bedroom
Cabinet and bed are located in the bedroom. You remember the keys are in the cabinet.

Luke follows right behind you.

* * *

>n
You can't go that way.

>w
You can't go that way.

* * *

>e
You can't go that way.

>s
Living room
You are in the sunny living room.

Luke follows right behind you.

>n
Bedroom
Cabinet and bed are located in the bedroom. You remember the keys are in the cabinet.

Luke follows right behind you.

>go down
Street
You head downstairs and out the door and you see the terribly damaged street. You take your keys out of your pocket, unlock the car and get in with Luke. You both decide the best thing to do would be to head to the gas station. You see only two paths, one being North and the other being East.

Luke follows right behind you.

>n
Hell
Luke follows right behind you.

    *** You and Luke have fallen into the Earth and died.

THE END  ***

Would you like to RESTART, RESTORE a saved game, QUIT or UNDO the last command?

* * *

>w
Street
You head downstairs and out the door and you see the terribly damaged street. You take your keys out of your pocket, unlock the car and get in with Luke. You both decide the best thing to do would be to head to the gas station. You see only two paths, one being North and the other being East.

Luke follows right behind you.

>e
Gas Station
You arrive at the gas station with barely any gas left. While Luke gets gas for the car you see two people. One looks confused and the other looks worried. You decide to see what's up with them. You first decide to talk to the short girl, Martha.

You can see Martha and Steve here.

Luke follows right behind you.

>e
Steve's House
You finally find the map and it is revealed to you that there is a secret shuttle in Russia that is saving only important people. You, Luke, and Steve take a good look at the map examining where you should go and conclude the first thing to do would be to go to the highway south of Steve's House and head to the Airport.

Luke follows right behind you.

* * *

>s
Highway
You forgot which way the airport was but you now you must continue on. You can either go South, East, or West.

Luke follows right behind you.

>w
Hell
Luke follows right behind you.

    *** You and Luke have fallen into the Earth and died.

THE END  ***

Would you like to RESTART, RESTORE a saved game, QUIT or UNDO the last command?

* * *

>talk to pilot
You ask the pilot if he is willing to help and you explain the plan. The pilot looks almost convinced so you look to see if there is anything on you that will make it a definite yes.

>i
You are carrying:
  Key
  100 Dollars
  Phone

* * *

>give money
Whom do you want to give 100 Dollars to?

>pilot
Pilot takes the 100 Dollars gladly and says to go ahead south to get to the plane so you could get out of there.

>s
Plane
Now that you have a rest time you decide to call your parents to let them know about the shuttle with the phone you had you. They were luckily already in Russia due to the vacation they were currently on. That makes things better. Your plane is going to east in order to get to Russia.

Luke follows right behind you.

>call parents
That's not a verb I recognise.

>e
Russia's Airport
When getting to the airport, a tragic flood occurs and it looks to be killing everyone. You look around to see what you can do about it and in the corner of the room you see an inflatable raft which you think is a good idea to grab.

You take the raft, already inflated and hightail it out of there. There are three possible exits but you don't have a clue which to pick. You can either go East, South, or North. Choose Wisely.

Luke follows right behind you.

* * *

>undo
Russia's Airport
[Previous turn undone.]

>n
Bridge
Unfortunately, Steve dies because he fell off the raft. Now it's only you and Luke. You also had a close call but Luke saved you. You think to yourself how good he is to you. Anyway, now you need to find out where the secret location is because it's not clear. You see a radio and go over to it to see it if you could possibly tune into a military station.

Luke follows right behind you.

>kiss luke
He not feeling it.　　コ

>look at radio
It comes in foggy but is soon apparent. The Secret Location to the shuttle is North of the Bridge.

* * *

>w
Shuttle
You finally make it! You are in the midst of some several thousand people but all you can think about is your family. You call for them and from across the room they come running to you. You have been extremely lucky. They leave to get food, leaving you and Luke alone. You don't know if he feels the same but you start wondering if you should be more than friends. In the spur of the moment, you decide you should kiss Luke.

Luke follows right behind you.

>kiss luke
    *** You kiss Luke and after a moment's pause he returns the kiss. You and Luke decide that you should be more than friends and go off happily. You are now saved and you have a new found relationship. You have won at life.

BE SAFE ***

Would you like to RESTART, RESTORE a saved game, QUIT or UNDO the last command?

* * *

>go w
You can't go that way.

>i
You are carrying:
  100 Dollars
  Phone

>go e
You can't go that way.

>kiss luke
He not feeling it.　　コ

>x luke
He is a good looking super hot super cool male. You have always felt a little attaracted.

>talk to luke
You ask Luke what he thinks you two should do.  He says that you two should grab the car keys located in the Bedroom north of the Living Room, and from the Bedroom go down to the car. From there you two should decide what the best thing to do would be.

>go u
You can't go that way.

>go up
You can't go that way.

>up
You can't go that way.

>go north
Bedroom
Cabinet and bed are located in the bedroom. You remember the keys are in the cabinet.

Luke follows right behind you.

>open cabinet
You open Wooden Cabinet, revealing Key.

* * *

>go down
Street
You head downstairs and out the door and you see the terribly damaged street. You take your keys out of your pocket, unlock the car and get in with Luke. You both decide the best thing to do would be to head to the gas station. You see only two paths, one being North and the other being East.

Luke follows right behind you.

>go e
Gas Station
You arrive at the gas station with barely any gas left. While Luke gets gas for the car you see two people. One looks confused and the other looks worried. You decide to see what's up with them. You first decide to talk to the short girl, Martha.

You can see Martha and Steve here.

Luke follows right behind you.

>talk to martha
You approach Martha and while you are attempting to get her attention she suddenly has a heart attack and dies. You freak out a little so you decide to head to the other person there who is named Steve.

* * *

>e
Steve's House
You finally find the map and it is revealed to you that there is a secret shuttle in Russia that is saving only important people. You, Luke, and Steve take a good look at the map examining where you should go and conclude the first thing to do would be to go to the highway south of Steve's House and head to the Airport.

Luke follows right behind you.

* * *

>s
Airport
You get to the airport and also see large crowds of confused people. It seems that no one is being allowed on the plane and the people are rioting. You see a lonely pilot hiding from the rioters in the corner of the room. You decide it would be best to talk to him.

You can see Pilot here.

Luke follows right behind you.

>s
Plane
Now that you have a rest time you decide to call your parents to let them know about the shuttle with the phone you had you. They were luckily already in Russia due to the vacation they were currently on. That makes things better. Your plane is going to east in order to get to Russia.

Luke follows right behind you.

I beg your pardon?

>n
Airport
You get to the airport and also see large crowds of confused people. It seems that no one is being allowed on the plane and the people are rioting. You see a lonely pilot hiding from the rioters in the corner of the room. You decide it would be best to talk to him.

You can see Pilot here.

Luke follows right behind you.

>talk to pilot
You ask the pilot if he is willing to help and you explain the plan. The pilot looks almost convinced so you look to see if there is anything on you that will make it a definite yes.

>give money
Whom do you want to give 100 Dollars to?

>to piolt
You can't see any such thing.

>pilot
That's not a verb I recognise.

>to pilot
That's not a verb I recognise.

>give money to pilot
Pilot takes the 100 Dollars gladly and says to go ahead south to get to the plane so you could get out of there.

I beg your pardon?

>s
Plane
Now that you have a rest time you decide to call your parents to let them know about the shuttle with the phone you had you. They were luckily already in Russia due to the vacation they were currently on. That makes things better. Your plane is going to east in order to get to Russia.

Luke follows right behind you.

* * *

>n
Bridge
Unfortunately, Steve dies because he fell off the raft. Now it's only you and Luke. You also had a close call but Luke saved you. You think to yourself how good he is to you. Anyway, now you need to find out where the secret location is because it's not clear. You see a radio and go over to it to see it if you could possibly tune into a military station.

Luke follows right behind you.

>n
Secret Location
You finally arrive and run into some guards. However, Luke convinces them to let you two past. You're really lucky to have him there. They tell you to go up to the glass doors and from there go west.

Luke follows right behind you.